太阳 : sun
升 : Lift
起 : rise
是 : yes
天 : sky
看 : look
上去 : Go up
下雨 : rain
妙 : wonderful
虹 : rainbow
更高 : higher
哇 : Wow
上 : superior
高山 : High mountain
惊人 : amazing
很 : very
棒 : Great
高 : high
愉悦 : Pleasant
钦佩 : admiration
哇 : Wow
雕像 : statue
上 : superior
极大 : great
欢 : joyous
愉快 : joy
远足 : Fascinating
顶部 : top
确实 : really
高兴 : Happy
开心 : happy
太好 : Great
上面 : above
看 : look
晴朗 : sunny
夜空 : Night sky
星星 : Star
美好 : good
很棒 : great
